OOOOOOOOOO
O O      O
O . OO O O
O O O    U
O OOOO OOO
O O O    