OOOOOOOOOO
O O    O O
O . OO   O
O O O   XO
O OOOO O O
O O O    O
O OOO OOOO
O O O    U
O O OOOOOO
O . O    O
OOOOOOOOOO
